w w w w w w w w w w w w w w w w w w
w f f f f f f f f f f f f f f f f e
w f f f f f f f f f f f f f f f f w
w f f f f f f f f f f f f f f f f w
w f f f f f f f f f f f f f f f f w
w f f f f f f f f f f f f f f f f w
w f f f f f f f f f f f f f f f f w
w f f f f f f f f f f f f f f f f w
s f f f f f f f f f f f f f f f f w
w w w w w w w w w w w w w w w w w w